XXXXXXXXXXXXXXXXXXXXXX
XG         G        GX
X          X         X
X                    X
X                    X
X                    X
XX                  XX
X                    X
X          X         X
X         X X        X
X        X   X       X
X       S    OX      X
XXXXXXXXXXXXXXXXXXXXXX